:1
A	Adam
B	Bertil
C	Cesar
D	David
E	Erik
F	Filip
G	Gustav
H	Helge
I	Ivar
J	Johan
K	Kalle
L	Ludvig
M	Martin
N	Niklas
O	Olof
P	Petter
Q	Qvintus
R	Rudolf
S	Sigurd
T	Tore
U	Urban
Ü	Übel
V	Viktor
W	Wilhelm
X	Xerxes
Y	Yngve
Z	Zäta
Å	Åke
Ä	Ärlig
Ö	Östen
